OBSTACLES: 100
HHHHHHHHHHHHHHHHHHHHHHHHHHHHHHHHHHHHHHHHHHHHHHHHHHHHHHHHHHHHHHHHHHHHHHHHHHHHHHHHHHHHHHHHHHHHHHHHHHHHHHHHHHHHHHHHHHHHHHHHHHHHHHHHHHHHHHHHHHHHHHHHHHHHHHHHHHHHHHHHHHHHHHHHHHHHHHHHHHHHHHHHHHHHHHHHHHHHHHHHHHHHHHHHHHHHHHHHHHHHHHHHHHHHHHHHHHHHHHHHH
GGGGGGGGGGGGGGEEEEEEGGGGGEEEEEEGGGGGGGGGGGGGGGGGGGGGGGGGGGGGGGGGGGGGGGGGGGGGGGGGGGGGGGGGGGGGGGGGGGGGEEGGGGGGGGGGGGGGGGGGEEEEGGGGGGGGGGGGGGGGGGGGGGGGGGGGGGGGGGGGGGGGGGEEEEEEEEEEGGGGGGGGGGGGGGEEGGGGGGEEEEEEEEEEEEEEEEEEEEEEEEEEEEEEEEEEEEEEEEEEG
G....@........GGEEEESSSSSEEEEGG......SS......P....PSSSSSSSSSSSSS.............SS.....P..EEEE.......P.EESS........P....P..EEEE...........S..SS..SSS....SSSS.......SSPPPPEEEEEEEEEESSSSS.........EE......GGEEEEEEEEEEEEEEEEEEEEEEEEEEEEEEEEEEEEEEEEG
G...............GGEE.....EEGG..........................................................GGGG.........EE..................EEGG..........................................EEEEEEEEEE..............SS........GGGGGEEEEEEEEEEEEEEEEEEEEEEEEEEEEEEEEEEEG
G.C...............GG.....GG............................................................SSSS.........EE..................GG............................................EEEEEEEEEE............................SGGGGGGGEEEEEEEEEEEEEEEEEEEEEEEEEEEEG
G.C................................................GGGGG.....GGG....................................EE..................SS............................................GGGGGGGGGG...................................SGGGGGGGEEEEEEEEEEEEEEEEEEEEEG
G.C......................................................GGG........................................GG...................................................................................................................SSGGGGGGGGGGGGGGGGGGGGGG
G.C............................................................................................................................................................................................................................................DG
G.C............................................................................................................................................................................................................................................TG
G.C.................................................................................................EE................................................................EEEEEEEEEE................................................................G
G.C.................................................................................................EE................................................................EEEEEEEEEE................................................................G
G.C.................................................................................................EE................................................................EEEEEEEEEE................................................................G
G...................................................................................................EE................................................................EEEEEEEEEE................................................................G
G...................................................................................................EE................................................................EEEEEEEEEE................................................................G
GGGGGGGGGGGGGGGGGGGGGGGGGGGGGGGGGGGGGGGGGGGGGGGGGGGGGGGGGGGGGGGGGGGGGGGGGGGGGGGGGGGGGGGGGGGGGGGGGGGGGGGGGGGGGGGGGGGGGGGGGGGGGGGGGGGGGGGGGGGGGGGGGGGGGGGGGGGGGGGGGGGGGGGGGGGGGGGGGGGGGGGGGGGGGGGGGGGGGGGGGGGGGGGGGGGGGGGGGGGGGGGGGGGGGGGGGGGGGGGGG