OBSTACLES: 100
HHHHHHHHHHHHHHHHHHHHHHHHHHHHHHHHHHHHHHHHHHHHHHHHHHHHHHHHHHHHHHHHHHHHHHHHHHHHHHHHHHHHHHHHHHHHHHHHHHHHHHHHHHHHHHHHHHHHHHHHHHHHHHHHHHHHHHHHHHHHHHHHHHHHHHHHHHHHHHHHHHHHHHHHHHHHHHHHHHHHHHHHHHHHHHHHHHHHHHHHHHHHHHHHHHHHHHHHHHHHHHHHHHHHHHHHHHHHHHHHH
GGGGGGGGGGGGGGGGGGGGGGGGGGGGGGGGGEEEEGGGEEEEEEEGGGGGGGGGGEEEGGGGGGGGGGGGGGGGEEGGGGGGGGGGGGGGGGGGGGGGEEEGGGGGGGGGGGGGGGGGGGGGGGGGGGGGGGGGGGGGGGGGGGGGGGGGGGGGGGGGGGGGGGGGGGGGGGGGGGGGGGGGGGGGGGGGGGGGGGGGGGGGGGGGGGGGGGGGGGGGGGGGGGGGGGGGGGGGGGGGG
G....@..........................................................................................................................................................................................................................................G
G...............................................................................................................................................................................................................................................G
G.C.............................................................................................................................................................................................................................................G
G.C.............................................................................................................................................................................................................................................G
G.C.............................................................................................................................................................................................................................................G
G.C.............................................................................................................................................................................................................................................G
G.C.............................................................................................................................................................................................................................................G
G.C.............................................................................................................................................................................................................................................G
G.C.............................................................................................................................................................................................................................................G
G.C.............................................................................................................................................................................................................................................G
G...............................................................................................................................................................................................................................................G
G...............................................................................................................................................................................................................................................G
GGGGGGGGGGGGGGGGGGGGGGGGGGGGGGGGGGGGGGGGGGGGGGGGGGGGGGGGGGGGGGGGGGGGGGGGGGGGGGGGGGGGGGGGGGGGGGGGGGGGGGGGGGGGGGGGGGGGGGGGGGGGGGGGGGGGGGGGGGGGGGGGGGGGGGGGGGGGGGGGGGGGGGGGGGGGGGGGGGGGGGGGGGGGGGGGGGGGGGGGGGGGGGGGGGGGGGGGGGGGGGGGGGGGGGGGGGGGGGGGG