OBSTACLES: 100
HHHHHHHHHHHHHHHHHHHHHHHHHHHHHHHHHHHHHHHHHHHHHHHHHHHHHHHHHHHHHHHHHHHHHHHHHHHHHHHHHHHHHHHHHHHHHHHHHHHHHHHHHHHHHHHHHHHHHHHHHHHHHHHHHHHHHHHHHHHHHHHHHHHHHHHHHHHHHHHHHHHHHHHHHHHHHHHHHHHHHHHHHHHHHHHHHHHHHHHHHHHHHHHHHHHHHHHHHHHHHHHHHHHHHHHHHHHHHHHHH
GGGGGGGGGGGGGGGGGGGGGGGGGGGGGGGGGEEEEGGGEEEEEEEGGGGGGGGGGEEEGGGGGGGGGGGGGGGGEEGGGGGGGGGGGGGGGGGGGGGGEEEGGGGGGGGGGGGGGGGGGGGGGGGGGGGGGGGGGGGGGGGGGGGGGGGGGGGGGGGGGGGGGGGGGGGGGGGGGGGGGGGGGGGGGGGGGGGGGGGGGGGGGGGGGGGGGGGGGGGGGGGGGGGGGGGGGGGGGGGGG
G....@...........................GGGG...GGEEEEESSSSSSSSSSEEE.............P..EE.......P........sss...EEE.........................................................................................................................................G
G.........................................GGEEE..........GGG................EE......................EEE.........................................................................................................................................G
G.C.........................................GGG...GGG....SSS................EE......................GGG.........................................................................................................................................G
G.C.........................................................................EE..................................................................................................................................................................G
G.C.........................................................................GG..................................................................................................................................................................G
G.C.................................................................................................EEE.........................................................................................................................................G
G.C.................................................................................................EEE.........................................................................................................................................G
G.C.................................................................................................EEE.........................................................................................................................................G
G.C.................................................................................................EEE.........................................................................................................................................G
G.C.................................................................................................EEE.........................................................................................................................................G
G...................................................................................................EEE.........................................................................................................................................G
G...................................................................................................EEE.........................................................................................................................................G
GGGGGGGGGGGGGGGGGGGGGGGGGGGGGGGGGGGGGGGGGGGGGGGGGGGGGGGGGGGGGGGGGGGGGGGGGGGGGGGGGGGGGGGGGGGGGGGGGGGGGGGGGGGGGGGGGGGGGGGGGGGGGGGGGGGGGGGGGGGGGGGGGGGGGGGGGGGGGGGGGGGGGGGGGGGGGGGGGGGGGGGGGGGGGGGGGGGGGGGGGGGGGGGGGGGGGGGGGGGGGGGGGGGGGGGGGGGGGGGGG