OBSTACLES: 100
HHHHHHHHHHHHHHHHHHHHHHHHHHHHHHHHHHHHHHHHHHHHHHHHHHHHHHHHHHHHHHHHHHHHHHHHHHHHHHHHHHHHHHHHHHHHHHHHHHHHHHHHHHHHHHHHHHHHHHHHHHHHHHHHHHHHHHHHHHHHHHHHHHHHHHHHHHHHHHHHHHHHHHHHHHHHHHHHHHHHHHHHHHHHHHHHHHHHHHHHHHHHHHHHHHHHHHHHHHHHHHHHHHHHHHHHHHHHHHHHH
GGGGGGGGGGGGGGGGGGGGGGGGGGGGGGGGGEEEEGGGEEEEEEEGGGGGGGGGGEEEGGGGGGGGGGGGGGGGEEGGGGGGGGGGGGGGGGGGGGGGEEEGGGGGGGGGGGGGGGGGEGGGGGGGGGGGEGGGGGGGGGGGGGGGGGGGGGGGGGGGGGGGGGGGGGGGGGGGEGGSSSSSSSSSSSSSSSSSSSSSSSSSSSSSSGGGGGGGGGGGGGGGGGGGGGGGGGGGGGGGGG
G....@...........................GGGG...GGEEEEESSSSSSSSSSEEE.............P..EE.......P........sss...EEESSSS........P....ESSSSSS.P...E......S......SS.......SSS..................G.............................G..................C..D...........G
G.........................................GGEEE..........GGG................EE......................EEE.................E...........E...............................................GG..................GG..........................T...........G
G.C.........................................GGG...GGG....SSS................EE......................GGG.................E...........E.....................................................GGG....GGG............................................G
G.C.........................................................................EE..........................................E...........E...........................................................................................................G
G.C.........................................................................GG..........................................G...........G...........................................................................................................G
G.C.................................................................................................EEE.........................................................................................................................................G
G.C.................................................................................................EEE.........................................................................................................................................G
G.C.................................................................................................EEE.........................................................................................................................................G
G.C.................................................................................................EEE.............................E...........................................................................................................G
G.C.................................................................................................EEE.............................E...........................................................................................................G
G...................................................................................................EEE.............................E...........................................................................................................G
G...................................................................................................EEE.............................E...........................................................................................................G
GGGGGGGGGGGGGGGGGGGGGGGGGGGGGGGGGGGGGGGGGGGGGGGGGGGGGGGGGGGGGGGGGGGGGGGGGGGGGGGGGGGGGGGGGGGGGGGGGGGGGGGGGGGGGGGGGGGGGGGGGGGGGGGGGGGGGGGGGGGGGGGGGGGGGGGGGGGGGGGGGGGGGGGGGGGGGGGGGGGGGGGGGGGGGGGGGGGGGGGGGGGGGGGGGGGGGGGGGGGGGGGGGGGGGGGGGGGGGGGGG