OBSTACLES: 100
HHHHHHHHHHHHHHHHHHHHHHHHHHHHHHHHHHHHHHHHHHHHHHHHHHHHHHHHHHHHHHHHHHHHHHHHHHHHHHHHHHHHHHHHHHHHHHHHHHHHHHHHHHHHHHHHHHHHHHHHHHHHHHHHHHHHHHHHHHHHHHHHHHHHHHHHHHHHHHHHHHHHHHHHHHHHHHHHHHHHHHHHHHHHHHHHHHHHHHHHHHHHHHHHHHHHHHHHHHHHHHHHHHHHHHHHHHHHHHHHH
GGGGGGGGGGGGSSGGGGEEEGGGGGGGGGGEGGGGGGGGGGGGGGGGGGGGGGGGGGGGGGGGGGGGGGGGGGGGGGGGGGGGGGGGGGEEEEEEEEEEEEEGGGGGGGGEEEEEGGSSSSSSSSSSSSSSSSSSSSSSSSSSSSSSGGGGGGGGGGGGGGGGGGGGGGGGGGGGGGGGGGGGGGGGGGGGGGGGGGGGGGGGGGGGGEGGGGGGGGGGGGGGGGGGGGGGGGGGGGGGG
G....@........S...GGG......P...E........P....P.....SSSSSSSSSS..............SSSS.........P.EEEEEEEEEEEGG........GGGGG................................SSS..........P.SSSSSSSSSSSS.........SSSSSSSS........P.......PE...........SS....S...........DG
G..................S...........E..........................................................EEEEEEEEEGG..............S.............................................................................................E.............................TG
G.C............................E.............................E.....GGGGGG.................EEEEEEEGG...................GGGGG..................GGGGGG..............................................................E..............................G
G.C............................E.............................E............................GGGGGGG.........................S...GGGGG..............................................................................E..............................G
G.C............................G...................G.........E................GGGGGG..............................................S...GGGGG......................................................................E..............................G
G.C................................................P.........E.....................S......................................................S................................GGGGGGGG..............................E..............................G
G.C..........................................................E.....GGGGG..........................................................................................................P..............................G..............................G
G.C............................E.............................E..................................................................................................................................................................................G
G.C............................E.............................G..................................................................................................................................................................................G
G.C............................E................................................................................................................................................................................................................G
G..............................E................................................................................................................................................................................................................G
G..............................E................................................................................................................................................................................................................G
GGGGGGGGGGGGGGGGGGGGGGGGGGGGGGGGGGGGGGGGGGGGGGGGGGGGGGGGGGGGGGGGGGGGGGGGGGGGGGGGGGGGGGGGGGGGGGGGGGGGGGGGGGGGGGGGGGGGGGGGGGGGGGGGGGGGGGGGGGGGGGGGGGGGGGGGGGGGGGGGGGGGGGGGGGGGGGGGGGGGGGGGGGGGGGGGGGGGGGGGGGGGGGGGGGGGGGGGGGGGGGGGGGGGGGGGGGGGGGGGG