OBSTACLES: 100
HHHHHHHHHHHHHHHHHHHHHHHHHHHHHHHHHHHHHHHHHHHHHHHHHHHHHHHHHHHHHHHHHHHHHHHHHHHHHHHHHHHHHHHHHHHHHHHHHHHHHHHHHHHHHHHHHHHHHHHHHHHHHHHHHHHHHHHHHHHHHHHHHHHHHHHHHHHHHHHHHHHHHHHHHHHHHHHHHHHHHHHHHHHHHHHHHHHHHHHHHHHHHHHHHHHHHHHHHHHHHHHHHHHHHHHHHHHHHHHHH
GGGGGGGGSSSSSSSSSSSSSSSSSSSSSSSSSSSSSSSSSSSSSSSSSSSSSSSSSSSGGGGGGSSSESSSSSSSSESSSSSSEESSSSSSSSSSSSSSSSSSSSSSSSSSSSSSSSSSSSSSGGGGGGGGGGGGGGGGGGGGGGGGGGGGGGGSSSSSSSEEESSSSSGSSSSSSSEEESSSSGSSSSSSGGGGGGGGGGGGGGGGGGGGGGGGGGGGGGGGGGGGGGGGGGGGGGGGG
G....@.......................................................P......E........G......GE..........................................S...SS...SSS...SS...SSS...P.......GGG.....P.......GGG....P.......S.............GGG.....SS....GGGGG....SSS......DG
G.......GGGGGG.........GGGGGG......................GGGGGG...........E........P......PE............................................................................S...............S.............................S..............SS..............TG
G.C..........S............P.................GGGGGG..................E................E.....GGGGG....GGGGGGGGGGGGGGGEEEEEE.......................................................................................................................G
G.C..............GGGG............................S..................E................E.........S............GGG....GGGGGG......................................................................................................................CG
G.C.................................................................E................E.......................S.......SSS.......................................................................................................................CG
G.C.................................................................E................G..........................................................................................................................................................G
G.C................................GGGGGG...........................G...........................................................................................................................................................................G
G.C.....................................S.......................................................................................................................................................................................................G
G.C..................................................................................E..........................................................................................................................................................G
G.C.................................................................E................E..........................................................................................................................................................G
G...................................................................E................E..........................................................................................................................................................G
G...................................................................E................E..........................................................................................................................................................G
GGGGGGGGGGGGGGGGGGGGGGGGGGGGGGGGGGGGGGGGGGGGGGGGGGGGGGGGGGGGGGGGGGGGGGGGGGGGGGGGGGGGGGGGGGGGGGGGGGGGGGGGGGGGGGGGGGGGGGGGGGGGGGGGGGGGGGGGGGGGGGGGGGGGGGGGGGGGGGGGGGGGGGGGGGGGGGGGGGGGGGGGGGGGGGGGGGGGGGGGGGGGGGGGGGGGGGGGGGGGGGGGGGGGGGGGGGGGGGGGG