OBSTACLES: 100
HHHHHHHHHHHHHHHHHHHHHHHHHHHHHHHHHHHHHHHHHHHHHHHHHHHHHHHHHHHHHHHHHHHHHHHHHHHHHHHHHHHHHHHHHHHHHHHHHHHHHHHHHHHHHHHHHHHHHHHHHHHHHHHHHHHHHHHHHHHHHHHHHHHHHHHHHHHHHHHHHHHHHHHHHHHHHHHHHHHHHHHHHHHHHHHHHHHHHHHHHHHHHHHHHHHHHHHHHHHHHHHHHHHHHHHHHHHHHHHHH
GGGGGGGGGGGGGGGGGGGGGGGGGGGGGGGGGEEEEGGGEEEEEEEGGGGGGGGGGEEEGGGGGGGGGGGGGGGGEEGGGGGGGGGGGGGGGGGGGGGGEEEGGGGGGGGGGGGGGGGGEGGGGGGGGGGGEGGGGGGGGGGGGGGGGGGGGGGGGGGGGGGGGGGGGGGGGGGEEGGSSSSSSSSSSSSSSSSSSSSSSSSSSSSSSGGGGGGGGGGGGGGGGGGGGGGGGGGGGGGGG
G....@...........................GGGG...GGEEEEESSSSSSSSSSEEE.............P..EE.......P........SSS..PEEESSSS........P...PESSSSSS.P..PE......S......SS.......SSS.................GG............................GG................................DG
G.........................................GGEEE..........GGG................EE......................EEE.................E...........E..............................................GGG..................GGG....................................TG
G...........................................GGG...GGG....SSS................EE......................GGG.................E...........E....................................................GGGG....GGGG...........................................G
GC..........................................................................EE..........................................E...........E...........................................................................................................G
GC..........................................................................GG..........................................G...........G...........................................................................................................G
GC..................................................................................................EEE.........................................................................................................................................G
GC..................................................................................................EEE.........................................................................................................................................G
GC..................................................................................................EEE.........................................................................................................................................G
G...................................................................................................EEE.............................E...........................................................................................................G
G...................................................................................................EEE.............................E...........................................................................................................G
G...................................................................................................EEE.............................E...........................................................................................................G
G...................................................................................................EEE.............................E...........................................................................................................G
GGGGGGGGGGGGGGGGGGGGGGGGGGGGGGGGGGGGGGGGGGGGGGGGGGGGGGGGGGGGGGGGGGGGGGGGGGGGGGGGGGGGGGGGGGGGGGGGGGGGGGGGGGGGGGGGGGGGGGGGGGGGGGGGGGGGGGGGGGGGGGGGGGGGGGGGGGGGGGGGGGGGGGGGGGGGGGGGGGGGGGGGGGGGGGGGGGGGGGGGGGGGGGGGGGGGGGGGGGGGGGGGGGGGGGGGGGGGGGGGG