OBSTACLES: 100
HHHHHHHHHHHHHHHHHHHHHHHHHHHHHHHHHHHHHHHHHHHHHHHHHHHHHHHHHHHHHHHHHHHHHHHHHHHHHHHHHHHHHHHHHHHHHHHHHHHHHHHHHHHHHHHHHHHHHHHHHHHHHHHHHHHHHHHHHHHHHHHHHHHHHHHHHHHHHHHHHHHHHHHHHHHHHHHHHHHHHHHHHHHHHHHHHHHHHHHHHHHHHHHHHHHHHHHHHHHHHHHHHHHHHHHHHHHHHHHHH
GGGGGGGGGGGGGGGGGGGGGGGGGGGGGGGGGGEEEEEEEEEEEEGGGGGGGGGGGSSGGGGGGGGGEEGGGGGGGEGGGGGGGGGEEGGGGGGGGGGGEEEEEEEEEEEGGGGGGGGGGGGGGGGGGGGGGGGGGGGGGGGGGGGGGGGGGGGGGGGGGGGGGGGGGGEEEEEGGGGGGGGGGGGGGGGGGGGGGGGGGGGGGGGGGGGGGGGGGGGGGGGGGGGGGGGGGGGGGGGGG
G....@............PPPSSSSSSSSSSS.PEEEEEEEEEEEESSSSS...........SS....GG.......E.....PP..EE........SSSGGGGGGGGGGGSSSSSSSSSSSSSSPPPSSSSSSSSSSSSS.................SSSSS.......EEEEE..............SSSSS..........................SS..GGGGGEEEEEEEEEEEG
G.................................EEEEEEEEEEEE......................SS.......G.........EE.................................................................................GGGGG.......EEE...........................................SGGGGEEEEEEEG
G.C...............................EEEEEEEEEEEE...............................S.........EE.........................GGGGGGGGGG..........................................................EEE................................................GGSEEEEG
G.C...............................EEEEEEEEEEEE.........................................EE........................................GGGGGG.................EEEEEEEEEEEEEEEEEEEEEEEEEEEEEEEEEEEEEEEEEEEEEEEEEEEEEEEEEEEEE.......................GGGGG
G.C...............................EEEEEEEEEGGG.........................................EE..............................................................EEEEEEEEEEEEEEEEEEEEEEEEEEEEEEEEEEEEEEEEEEEEEEEEEEEEEEEEEEEEEEEE........................DG
G.C..................GGG..........EEEEEEGGG............................................EE.............................................................GEEEEEEEEEEEEEEEEEEEEEEEEEEEEEEEEEEEEEEEEEEEEEEEEEEEEEEEEEEEEEEEEGG......................TG
G.C......................GGG......EEEGGG...............................................SS........................................EEEEEE.................GEEEEEEEEEEEEEEEEEEEEEEEEEEEEEEEEEEEEEEEEEEEEEEEEEEEEEEEEEEEEGG.........................G
G.C..........................GGG..GGG.......EE...............GGG.................................................................EEEEEE..................GGGGGGGGGGGGGGGGGGGGGGGEEGGGGGGGGGGGGGGGGGGGGGGGGGGGGGGGGGGG........GGGG...............G
G.C......................................EEEEE...................................................................................EEEEEE...........................PP............EE.......PP.......SSSS........................S.................G
G.C...................................EEEEEEEE...................................................................................EEEEEE.........................................GG.............................EEEE.............................G
G.................................EEEEEEEEEEEE...................................................................................EEEEEE....................................EE.......EE........................EEEEEE............................G
G.................................EEEEEEEEEEEE...................................................................................EEEEEE....................................EE.......EE.......................EEEEEEEE...........................G
GGGGGGGGGGGGGGGGGGGGGGGGGGGGGGGGGGGGGGGGGGGGGGGGGGGGGGGGGGGGGGGGGGGGGGGGGGGGGGGGGGGGGGGGGGGGGGGGGGGGGGGGGGGGGGGGGGGGGGGGGGGGGGGGGGGGGGGGGGGGGGGGGGGGGGGGGGGGGGGGGGGGGGGGGGGGGGGGGGGGGGGGGGGGGGGGGGGGGGGGGGGGGGGGGGGGGGGGGGGGGGGGGGGGGGGGGGGGGGGGG