OBSTACLES: 100
HHHHHHHHHHHHHHHHHHHHHHHHHHHHHHHHHHHHHHHHHHHHHHHHHHHHHHHHHHHHHHHHHHHHHHHHHHHHHHHHHHHHHHHHHHHHHHHHHHHHHHHHHHHHHHHHHHHHHHHHHHHHHHHHHHHHHHHHHHHHHHHHHHHHHHHHHHHHHHHHHHHHHHHHHHHHHHHHHHHHHHHHHHHHHHHHHHHHHHHHHHHHHHHHHHHHHHHHHHHHHHHHHHHHHHHHHHHHHHHHH
GGGGGGGGGGGGGGGGGGGGGGGGGGGGGGGGGEEEEGGGEEEEEEEGGGGGGGGGGEEEGGGGGGGGGGGGGGGGEEGGGGGGGGGGGGGGGGGGGGGGEEEGGGGGGGGGGGGGGGGGGGGGGGGGGGGGGGGGGGGGGGGGGGGGGGGGGGGGGGGGGGGGGGGGGGGGGGGGGGGGGGGGGGGGGGGGGGGGGGGGGGGGGGGGGGGGGGGGGGGGGGGGGGGGGGGGGGGGGGGGG
G....@...............PPPE........GGGG...GGEEEEESSSSSSSSSSEEE.............P..EE.......P........sss...EEE.........................................................................................................................................G
G.......................E.................GGEEE..........GGG................EE......................EEE.........................................................................................................................................G
G.C.....................E...................GGG...GGG....SSS................EE......................GGG.........................................................................................................................................G
G.C.....................G...................................................EE..................................................................................................................................................................G
G.C.........................................................................GG..................................................................................................................................................................G
G.C.................................................................................................EEE.........................................................................................................................................G
G.C.................................................................................................EEE.........................................................................................................................................G
G.C.................................................................................................EEE.........................................................................................................................................G
G.C.................................................................................................EEE.........................................................................................................................................G
G.C.................................................................................................EEE.........................................................................................................................................G
G...................................................................................................EEE.........................................................................................................................................G
G...................................................................................................EEE.........................................................................................................................................G
GGGGGGGGGGGGGGGGGGGGGGGGGGGGGGGGGGGGGGGGGGGGGGGGGGGGGGGGGGGGGGGGGGGGGGGGGGGGGGGGGGGGGGGGGGGGGGGGGGGGGGGGGGGGGGGGGGGGGGGGGGGGGGGGGGGGGGGGGGGGGGGGGGGGGGGGGGGGGGGGGGGGGGGGGGGGGGGGGGGGGGGGGGGGGGGGGGGGGGGGGGGGGGGGGGGGGGGGGGGGGGGGGGGGGGGGGGGGGGGGG